Name	title	coding
t3_qld6e8	Sending Transcripts before application	
t3_qmgzy4	BIOL215 midterm thoughts?	
t3_qlkky5	How do conference participation grades work?	
t3_qm3vyp	Thoughts on taking Mech 383 in U1	
t3_qlbf2t	COMP 202 vs 204	
t3_qncnpo	Question about Richard Roy	
t3_qmsx3x	atm near campus	
t3_qltp0b	Struggling first year	
t3_qmxg3q	seeing a dermatologist as an intl student	
t3_qm0646	Psyc 395	
t3_ql6ux7	What happens if I fail a required course twice?	
t3_qmsh3a	Do I need to retake a course I get a J in if it’s just an elective?	
t3_qktks4	Is it still possible to S/U a class or not?	
t3_qktgkc	cloudberry 2, 3, and 4 spotted at parc la fontaine	
t3_qmc0og	Skateboarders of MCGILL...where you at???	
t3_qn8xww	Hot water on campus?	
t3_qm13su	Are there paid focus groups or other temporary jobs nearby?	
t3_qn2tjp	midterm grade and course grade	
t3_qn2sji	REAL TALK FRIDAY	
t3_ql9brj	Comp251 Midterm	
t3_qlxgan	Places to eat in Griffintown?	
t3_ql90vt	Found all my class's assignments on Chegg	
t3_qleztt	Transferring to neuroscience	
t3_ql4hln	Has anyone taken ECSE552 (Deep Learning) and/or know how it compares to COMP551 (Applied Machine Learning) ?	
t3_qmlgoo	Flex-Spaces - Fall 2021 - Recommendation	
t3_qlnvja	General tips for COMP 417 w/ Dudek	
t3_qlv7an	psychology research student participant pool?	
t3_qm8s16	Will MATH324 be offered this summer?	
t3_qlxf9c	Has anyone had any experience studying abroad?	
t3_qlefrj	It’s so awkward being poor	
t3_qm1kf6	May need to make accommodations in case of family emergencies. Whom should I talk to and what should I prepare	
t3_qks2u6	ALWAYS check your receipt at Marché Lobo (got overcharged $13.50)	
t3_qm8ce9	How good/bad does a 3.2 gpa look on a CV?	
t3_qm74z9	Graduate studies	
t3_ql4sls	Haircuts in montreal	
t3_qm9bs9	good, cheap plant stores!	
t3_ql4v1e	Neurologist in Montreal	
t3_qlcpyu	McLennan Toi Moi &amp; Café is so bad I need a refund	
t3_qn4wz0	Orthodontist for International student	
t3_qlbi8a	There’s a lot of apparent sadness on this page. Anyone been happy as hell lately (or pretty happy at least)?	
t3_qmpl37	LOST MY KEYS NEAR MCGILL details in comments please return if found it is a very sentimental item.	
t3_qmn9u7	If you have a dog in the Plateau beware of 2 women with a large poodle(?)	
t3_ql5q2w	Asking for reference letters for grad school	
t3_qmuiwp	Unwell Woman in Burnside ground staircase	
t3_qloppc	Principles of Toxicology! Help!	
t3_qldkrb	Where to find McGill apparel for cheap or discounted prices?	
t3_qlhftr	Late withdrawal from 2 courses- please help!	
t3_qm0slu	Math 556 midterm: thoughts ?	
t3_qmb23a	Will BIOL 112 be in person?	
t3_ql6bwr	Hold on Registration	
